"filename", "language", "JSON", "YAML", "Swift", "Dart", "Groovy", "comment", "blank", "total"
"c:\Users\julsa\Documents\Barang jul\Document\Kuliah\Cawu 4\Software Engineering\Project\Uangin_alpha\uangin\android\app\build.gradle", "Groovy", 0, 0, 0, 0, 3, 0, 1, 4
"c:\Users\julsa\Documents\Barang jul\Document\Kuliah\Cawu 4\Software Engineering\Project\Uangin_alpha\uangin\android\app\google-services.json", "JSON", 46, 0, 0, 0, 0, 0, 0, 46
"c:\Users\julsa\Documents\Barang jul\Document\Kuliah\Cawu 4\Software Engineering\Project\Uangin_alpha\uangin\android\build.gradle", "Groovy", 0, 0, 0, 0, 1, 0, 0, 1
"c:\Users\julsa\Documents\Barang jul\Document\Kuliah\Cawu 4\Software Engineering\Project\Uangin_alpha\uangin\ios\firebase_app_id_file.json", "JSON", 7, 0, 0, 0, 0, 0, 0, 7
"c:\Users\julsa\Documents\Barang jul\Document\Kuliah\Cawu 4\Software Engineering\Project\Uangin_alpha\uangin\lib\classes\auth_controller.dart", "Dart", 0, 0, 0, 41, 0, 0, 15, 56
"c:\Users\julsa\Documents\Barang jul\Document\Kuliah\Cawu 4\Software Engineering\Project\Uangin_alpha\uangin\lib\contents\campuran.dart", "Dart", 0, 0, 0, 24, 0, 0, 1, 25
"c:\Users\julsa\Documents\Barang jul\Document\Kuliah\Cawu 4\Software Engineering\Project\Uangin_alpha\uangin\lib\contents\home.dart", "Dart", 0, 0, 0, 262, 0, 28, 42, 332
"c:\Users\julsa\Documents\Barang jul\Document\Kuliah\Cawu 4\Software Engineering\Project\Uangin_alpha\uangin\lib\contents\invest.dart", "Dart", 0, 0, 0, 55, 0, 0, 10, 65
"c:\Users\julsa\Documents\Barang jul\Document\Kuliah\Cawu 4\Software Engineering\Project\Uangin_alpha\uangin\lib\contents\pasaruang.dart", "Dart", 0, 0, 0, 16, 0, 0, 1, 17
"c:\Users\julsa\Documents\Barang jul\Document\Kuliah\Cawu 4\Software Engineering\Project\Uangin_alpha\uangin\lib\contents\pendapatantetap.dart", "Dart", 0, 0, 0, 22, 0, 0, 0, 22
"c:\Users\julsa\Documents\Barang jul\Document\Kuliah\Cawu 4\Software Engineering\Project\Uangin_alpha\uangin\lib\contents\profil.dart", "Dart", 0, 0, 0, 170, 0, 22, 22, 214
"c:\Users\julsa\Documents\Barang jul\Document\Kuliah\Cawu 4\Software Engineering\Project\Uangin_alpha\uangin\lib\contents\saham.dart", "Dart", 0, 0, 0, 22, 0, 0, 0, 22
"c:\Users\julsa\Documents\Barang jul\Document\Kuliah\Cawu 4\Software Engineering\Project\Uangin_alpha\uangin\lib\contents\transaksi.dart", "Dart", 0, 0, 0, 282, 0, 3, 11, 296
"c:\Users\julsa\Documents\Barang jul\Document\Kuliah\Cawu 4\Software Engineering\Project\Uangin_alpha\uangin\lib\firebase_options.dart", "Dart", 0, 0, 0, 66, 0, 12, 6, 84
"c:\Users\julsa\Documents\Barang jul\Document\Kuliah\Cawu 4\Software Engineering\Project\Uangin_alpha\uangin\lib\main.dart", "Dart", 0, 0, 0, 38, 0, 4, 3, 45
"c:\Users\julsa\Documents\Barang jul\Document\Kuliah\Cawu 4\Software Engineering\Project\Uangin_alpha\uangin\lib\pages\changepinpage.dart", "Dart", 0, 0, 0, 9, 0, 5, 3, 17
"c:\Users\julsa\Documents\Barang jul\Document\Kuliah\Cawu 4\Software Engineering\Project\Uangin_alpha\uangin\lib\pages\changepinpage2.dart", "Dart", 0, 0, 0, -2, 0, 4, 0, 2
"c:\Users\julsa\Documents\Barang jul\Document\Kuliah\Cawu 4\Software Engineering\Project\Uangin_alpha\uangin\lib\pages\changepinpage3.dart", "Dart", 0, 0, 0, 4, 0, 4, 1, 9
"c:\Users\julsa\Documents\Barang jul\Document\Kuliah\Cawu 4\Software Engineering\Project\Uangin_alpha\uangin\lib\pages\homepage.dart", "Dart", 0, 0, 0, 110, 0, 9, 8, 127
"c:\Users\julsa\Documents\Barang jul\Document\Kuliah\Cawu 4\Software Engineering\Project\Uangin_alpha\uangin\lib\pages\loginpage.dart", "Dart", 0, 0, 0, 186, 0, 1, 19, 206
"c:\Users\julsa\Documents\Barang jul\Document\Kuliah\Cawu 4\Software Engineering\Project\Uangin_alpha\uangin\lib\pages\mainpage.dart", "Dart", 0, 0, 0, 0, 0, 1, 5, 6
"c:\Users\julsa\Documents\Barang jul\Document\Kuliah\Cawu 4\Software Engineering\Project\Uangin_alpha\uangin\lib\pages\pinpage.dart", "Dart", 0, 0, 0, 23, 0, 3, 14, 40
"c:\Users\julsa\Documents\Barang jul\Document\Kuliah\Cawu 4\Software Engineering\Project\Uangin_alpha\uangin\lib\pages\reksadana\reksadanadetailpage.dart", "Dart", 0, 0, 0, 1365, 0, 78, 41, 1484
"c:\Users\julsa\Documents\Barang jul\Document\Kuliah\Cawu 4\Software Engineering\Project\Uangin_alpha\uangin\lib\pages\saham\sahammorepage.dart", "Dart", 0, 0, 0, 239, 0, 33, 38, 310
"c:\Users\julsa\Documents\Barang jul\Document\Kuliah\Cawu 4\Software Engineering\Project\Uangin_alpha\uangin\lib\pages\sbnpage.dart", "Dart", 0, 0, 0, 0, 0, 0, 2, 2
"c:\Users\julsa\Documents\Barang jul\Document\Kuliah\Cawu 4\Software Engineering\Project\Uangin_alpha\uangin\lib\pages\setortunaipage.dart", "Dart", 0, 0, 0, 1, 0, 0, 0, 1
"c:\Users\julsa\Documents\Barang jul\Document\Kuliah\Cawu 4\Software Engineering\Project\Uangin_alpha\uangin\lib\pages\tarikTunai\tariktunaipage.dart", "Dart", 0, 0, 0, 431, 0, 10, 35, 476
"c:\Users\julsa\Documents\Barang jul\Document\Kuliah\Cawu 4\Software Engineering\Project\Uangin_alpha\uangin\lib\pages\tarikTunai\tariktunaipinpage.dart", "Dart", 0, 0, 0, 687, 0, 14, 80, 781
"c:\Users\julsa\Documents\Barang jul\Document\Kuliah\Cawu 4\Software Engineering\Project\Uangin_alpha\uangin\lib\pages\tarikTunai\tariktunaireceiptpage.dart", "Dart", 0, 0, 0, 177, 0, 3, 40, 220
"c:\Users\julsa\Documents\Barang jul\Document\Kuliah\Cawu 4\Software Engineering\Project\Uangin_alpha\uangin\lib\pages\transaksi\mutasi.dart", "Dart", 0, 0, 0, 203, 0, 12, 23, 238
"c:\Users\julsa\Documents\Barang jul\Document\Kuliah\Cawu 4\Software Engineering\Project\Uangin_alpha\uangin\lib\pages\transaksi\pembelian.dart", "Dart", 0, 0, 0, 197, 0, 3, 5, 205
"c:\Users\julsa\Documents\Barang jul\Document\Kuliah\Cawu 4\Software Engineering\Project\Uangin_alpha\uangin\lib\pages\transaksi\pemesanancontent.dart", "Dart", 0, 0, 0, 170, 0, 1, 9, 180
"c:\Users\julsa\Documents\Barang jul\Document\Kuliah\Cawu 4\Software Engineering\Project\Uangin_alpha\uangin\lib\pages\transaksi\pemesananwidget.dart", "Dart", 0, 0, 0, 116, 0, 0, 4, 120
"c:\Users\julsa\Documents\Barang jul\Document\Kuliah\Cawu 4\Software Engineering\Project\Uangin_alpha\uangin\lib\pages\transaksi\penjualan.dart", "Dart", 0, 0, 0, 216, 0, 2, 5, 223
"c:\Users\julsa\Documents\Barang jul\Document\Kuliah\Cawu 4\Software Engineering\Project\Uangin_alpha\uangin\lib\pages\transaksi\riwayatcontent.dart", "Dart", 0, 0, 0, 93, 0, 1, 10, 104
"c:\Users\julsa\Documents\Barang jul\Document\Kuliah\Cawu 4\Software Engineering\Project\Uangin_alpha\uangin\lib\pages\transaksi\semua.dart", "Dart", 0, 0, 0, 564, 0, 22, 32, 618
"c:\Users\julsa\Documents\Barang jul\Document\Kuliah\Cawu 4\Software Engineering\Project\Uangin_alpha\uangin\lib\pages\transfer\transferconfirmationpage.dart", "Dart", 0, 0, 0, 405, 0, 20, 32, 457
"c:\Users\julsa\Documents\Barang jul\Document\Kuliah\Cawu 4\Software Engineering\Project\Uangin_alpha\uangin\lib\pages\transfer\transferpage.dart", "Dart", 0, 0, 0, 250, 0, 12, 23, 285
"c:\Users\julsa\Documents\Barang jul\Document\Kuliah\Cawu 4\Software Engineering\Project\Uangin_alpha\uangin\lib\pages\transfer\transferpinpage.dart", "Dart", 0, 0, 0, 687, 0, 14, 78, 779
"c:\Users\julsa\Documents\Barang jul\Document\Kuliah\Cawu 4\Software Engineering\Project\Uangin_alpha\uangin\lib\pages\transfer\transferreceipt.dart", "Dart", 0, 0, 0, 244, 0, 44, 67, 355
"c:\Users\julsa\Documents\Barang jul\Document\Kuliah\Cawu 4\Software Engineering\Project\Uangin_alpha\uangin\macos\Flutter\GeneratedPluginRegistrant.swift", "Swift", 0, 0, 8, 0, 0, 0, 0, 8
"c:\Users\julsa\Documents\Barang jul\Document\Kuliah\Cawu 4\Software Engineering\Project\Uangin_alpha\uangin\macos\firebase_app_id_file.json", "JSON", 7, 0, 0, 0, 0, 0, 0, 7
"c:\Users\julsa\Documents\Barang jul\Document\Kuliah\Cawu 4\Software Engineering\Project\Uangin_alpha\uangin\pubspec.yaml", "YAML", 0, 10, 0, 0, 0, 0, 0, 10
"Total", "-", 60, 10, 8, 7373, 4, 365, 686, 8506